g	ց ꝯ ǵ ɡ ḡ ꞡ ᶃ Ɡ ໘ 𑣏 ġ ğ ǧ ９ ꬶ ĝ 9 ǥ
1	𐤂 𑃲
c	ᥴ ᴄ 🝌 𐐕 Σ 𑫂 ꓚ Ⲥ с 𐐽 C 𐊢 ｃ ⲥ ¢ ⅽ 𐔛 ϲ 𖼐 ᲃ
2	Ⲹ
s	𐐠 ѕ ട ｓ 𖹪 ຮ ꂢ ᥉ ຣ 𐍃 𐑈 𑛈 ડ ร 𖼺 S ಽ Տ ꓢ ꮪ
o	၀ ᭵ ߋ ჿ ᦞ о 𑶠 ꧆ ⲟ 𐐬 ᪀ ௦ ᧐ 𐓪 ᭐ 𐔖 ꧐ 𑵐 𐑴
m	ጠ ጣ 𖬢 ՠ n ᗰ 𑴮 ท ⅿ ៣ ꦒ ṃ ⴖ ҭ ᶆ ꧑
h	ｈ ꞕ һ ɦ Ⴙ ի 𐌷 Һ ԧ ℎ ⱨ ℏ Ԧ ♄ ⴙ
i	ຳ أ ɨ ﺃ í Ꭵ ⅰ 🕴 ℹ ї ⭱ і ⅈ Ⳕ ⳕ ｉ ỉ ¡ וֹ ì
a	ᨡ ầ ā 𖫝 ล â ả à а ä ą á ᶏ ǎ ａ å ă ã ᥑ ส
l	ߊ 𖭐 ㆐ ꡶ ꓲ 𑫥 ᛁ Ⲓ ꒐ 𑑋 𑪛 𐴱 𐣻 𑀭 𖼨 𐣭 𐌉 ⅼ 𖩙 𐌠
b	𝈇 Ხ ␢ ᑲ ƅ ߕ ƀ Ь ხ ḇ ߿ 𐔽 ｂ þ 𐓄 ḅ ɓ ᵬ
t	⮬ 𖼹 ţ ₶ ṭ ｔ ﴼ ť ΐ ΐ ṯ ꮏ 🠑 ʈ ੯ ț Ꝉ ﾋ ੮ ƭ
k	ⲕ ꓗ Ǩ 𐌊 ⱪ ꞣ Κ ҟ ḳ 𐔘 ķ K ꝁ ƙ Ƙ Ќ
p	ᑭ Ⲣ ρ 𐼜 ƿ Ｐ р Р ｐ ⳏ ꝓ P Ꝑ ᱞ ꓑ ꛤ Ῥ
n	ກ ໗ ⴄ ꞑ ⲡ ຖ ո m ท ղ 𐔗 𖬢 ｎ ᥒ 𐌿 ⅿ ח ฑ ՠ ⴖ
u	U ս Ս ⳙ ꓴ Ա 𑚞 ｕ 𐓶 𖽂 ߎ ບ น ⴎ ม ա ⴍ ᥙ
e	ၔ ꬳ ࿉ ｅ ẻ ဧ ė è ę ᧉ е ၕ ҽ ⱸ ē ᥱ ẹ ꋠ ⅇ ꫀ
j	ĳ ϳ Ϳ ꆼ ｊ
r	ᡵ ᠵ ᡕ ꭇ ⸀ 𐌲 ⲅ 𝈬 ｒ 𐔏 ᡪ ᠷ 𐼗 ෦ ᴦ ŗ ⸢ г ୮ ꭈ
v	𐰟 ݍ ꛟ 𐌖 ꤂ ⅴ ۷ 𖼈
y	ỷ ý Ў ꮍ У у ｿ Ỿ ỵ ℽ Ꮍ ƴ ÿ ｙ ꭹ Ꭹ
d	ḍ ｄ ꒬ đ Ძ ḏ ꁐ ꒮ 𑫙 ꒯ ძ ḋ ᑯ Ԁ ԁ ɗ 𑀘 ꓒ ď
w	ѡ พ Ꮤ ᗐ ꮤ Ⱳ ꟽ Ẉ Ԝ ｗ ꛃ
f	ٲ ḯ 𑃱 𐙗 ӻ ꄷ ﬀ ƭ í 🛉 𑣂 𐙵
q	ｑ
x	х 𑀋 𐊴 ꓫ ᚷ
-	٠
z	ᤁ ꛉ ℤ
5	５
