g	໘ ĝ ǵ ḡ ǧ ց 𑣏 ꬶ ９ ġ ᶃ Ɡ 9 ꝯ ꞡ ǥ ɡ ğ
1	𐤂 𑃲
c	ⅽ с C ϲ 𐔛 𐐕 𖼐 ｃ ꓚ ᲃ Σ ⲥ ¢ ᴄ ᥴ 𐐽 🝌 𑫂 Ⲥ 𐊢
2	Ⲹ
s	ร ಽ ᥉ 𐐠 𐑈 ડ ꓢ ѕ 𖹪 S ꮪ ｓ ꂢ 𐍃 ຮ ຣ Տ 𖼺 𑛈 ട
o	𐔖 ꧐ 𑵐 ᭵ 𑶠 ᧐ ᦞ ჿ 𐐬 𐑴 ᭐ ꧆ ߋ о ௦ ᪀ ⲟ 𐓪 ၀
m	ҭ ⅿ ꧑ ՠ n ጠ ⴖ ṃ ៣ ท ጣ 𖬢 ᗰ 𑴮 ꦒ ᶆ
h	һ ℏ ꞕ ⱨ ի ℎ Ⴙ Һ ԧ 𐌷 ⴙ ♄ ɦ ｈ Ԧ
i	וֹ ⳕ Ꭵ ℹ ⅈ ɨ í ⅰ أ ì ｉ ї ﺃ ຳ і 🕴 Ⳕ ỉ ¡ ⭱
a	ả á ä ส ล ă ᨡ 𖫝 ầ а ã ａ ᥑ å à ā ᶏ ǎ ą â
l	𐌉 ꒐ ᛁ ꓲ ⅼ ꡶ 𑫥 𖼨 ㆐ 𐴱 Ⲓ 𑀭 𑪛 𐌠 ߊ 𖭐 𖩙 𐣻 𐣭 𝍩
b	Ხ ᵬ ƅ ｂ ხ ƀ ḅ ␢ 𐓄 ɓ ḇ ᑲ 𐔽 ߕ 𝈇 Ь ߿ þ
t	ꮏ ț ƭ Ꝉ 𖼹 ੯ ₶ ṭ ｔ ΐ ʈ ⮬ ṯ ੮ 🠑 ţ ﾋ ﴼ ΐ ť
k	Ƙ 𐔘 ⲕ ⱪ ķ ƙ ꝁ ꞣ Ḱ Ⲕ K Κ 𐌊 K ҟ Ќ
p	ꛤ 𐼜 Р Ῥ ⳏ Ꝑ ρ ｐ Ｐ ᑭ р ᱞ ꝓ P Ⲣ ꓑ ƿ
n	ｎ ກ ղ ໗ ח ⲡ ⴖ ո 𐌿 ꞑ 𖬢 ՠ ຖ ⴄ ฑ m ⅿ 𐔗 ᥒ ท
u	Ս Ա 𑚞 ᥙ ｕ ꓴ ບ ⳙ 𖽂 ա ⴎ ս น 𐓶 ߎ ม U ⴍ
e	ᥱ ⱸ ⅇ ē ę è 𐹲 ᧉ ｅ ẻ ၕ ꫀ ė е ҽ ၔ ꋠ ဧ ꬳ ẹ
j	ꆼ ϳ ĳ Ϳ ｊ
r	ᠷ ᡪ ŗ ᠵ ෦ ⲅ ⸢ ꭈ 𐌲 ᴦ ⸀ ｒ г ୮ ᡵ 𐔏 𐼗 ꭇ ᡕ 𝈬
v	꤂ ۷ 𐌖 𖼈 ݍ 𐰟 ⅴ ꛟ
y	ÿ ｿ ꭹ У ỷ ｙ Ꮍ ƴ ỵ ꮍ у ý Ỿ Ў Ꭹ ℽ
d	ᑯ ɗ ḏ ꒮ ḍ ძ 𑀘 ꓒ ꒯ đ Ԁ ḋ ď 𑫙 ꁐ ԁ Ძ ｄ 𐆋
w	Ԝ Ⱳ Ꮤ ꮤ ᗐ ｗ Ẉ พ ꟽ ѡ ꛃ
f	ӻ ḯ 𑣂 ꄷ 🛉 ٲ í 𐙗 𑃱 𐙵 ﬀ ƭ
q	ｑ
x	𑀋 х ᚷ 𐊴 ꓫ
-	٠
z	ᤁ ℤ Z
5	５
